XXXXXXXXXXXXXXXXXXXXXXXXXXX
X...........X.....X.....X.X
XXXXXXXXX.X.X.XXX.X.X.X.X.X
X.....X...X...X.X.X.X.X.X.X
X.XXX.X.XXXX.XX.X.XXX.X.X.X
X...X...X.......X.X...X.X.X
X.X.XXXXXXX.XXXXX.X.XXX.X.X
X.X...X...X.X...X...X.....X
X.XXX.X.XXXXX.XXX.XXX.XXX.X
X.X...X...X...X...X.....X.X
X.X.XXXXXXXXXXX.X.X.X.XXX.X
X.X.X.........X.X.X.X.....X
X.X.X.XXX.XXX.X.X.XXX.XXXXX
X.X.X...X...X.X.X...X.X...X
X.X.XXX.X.X.X.X.XXX.XXX.X.X
X.X.......X.X.....X.....X.X
XXXXXXXXXXXXXXXXXXXXXXXXXXX
